Auto - Car
Motorrad - Motorcycle
LKW (Lastkraftwagen) - Truck
PKW (Personenkraftwagen) - Car
Reifen - Tire
Lenkrad - Steering wheel
Motor - Engine
Benzin - Gasoline
Diesel - Diesel
Tankstelle - Gas station
Bremsen - Brakes
Kupplung - Clutch
Gangschaltung - Gearshift
Getriebe - Transmission
Kofferraum - Trunk
Stoßstange - Bumper
Scheinwerfer - Headlights
Blinker - Turn signal
Rückspiegel - Rearview mirror
Hupe - Horn
Auspuff - Exhaust
Scheibenwischer - Windshield wipers
Fenster - Window
Sitz - Seat
Sicherheitsgurt - Seatbelt
Tacho - Speedometer
Hupe - Horn
Klimaanlage - Air conditioning
Heizung - Heater
Radio - Radio
Navigationssystem - Navigation system
Tempomat - Cruise control
Parkplatz - Parking lot
Nummernschild - License plate
Tankdeckel - Gas cap
Bremsscheibe - Brake disc
Handbremse - Handbrake
Motorhaube - Hood
Rücksitz - Back seat
Steckdose - Power outlet
Stoßdämpfer - Shock absorber
Radkappe - Wheel cover
Zündschlüssel - Ignition key
Anlasser - Starter
Batterie - Battery
Zündkerze - Spark plug
Scheibenbremsen - Disc brakes
Kraftstoff - Fuel
Getriebeschaltung - Gear shift
Bremssattel - Brake caliper
Kühlergrill - Radiator grille
Stoßdämpfer - Shock absorber
Katalysator - Catalytic converter
Motoröl - Motor oil
Servolenkung - Power steering
Schalldämpfer - Muffler
Ölwechsel - Oil change
Zündung - Ignition
Luftfilter - Air filter
Abgas - Exhaust gas
Scheibenbremse - Disc brake
Abblendlicht - Low beam
Fernlicht - High beam
Kühler - Radiator
Kupplungsgeberzylinder - Clutch master cylinder
Kupplungsnehmerzylinder - Clutch slave cylinder
Rad - Wheel
Lenksäule - Steering column
Stoßfänger - Bumper
Kraftstofftank - Fuel tank
Dachgepäckträger - Roof rack
Bremsflüssigkeit - Brake fluid
Motorsteuerung - Engine control
Antriebswelle - Driveshaft
Stoßdämpfer - Shock absorber
Scheinwerferlampe - Headlight bulb
Antriebsriemen - Drive belt
Kühlflüssigkeit - Coolant
Kraftstofffilter - Fuel filter
Radlager - Wheel bearing
Traktionskontrolle - Traction control
Radmutter - Lug nut
Abgasanlage - Exhaust system
Abgaskrümmer - Exhaust manifold
Zahnriemen - Timing belt
Ventil - Valve
Kühlerlüfter - Radiator fan
Abgasrückführung - Exhaust gas recirculation
Zündkabel - Ignition cable
Lenkgetriebe - Steering gear
Radnabe - Wheel hub
Kühlerdeckel - Radiator cap
Zündverteiler - Distributor
Schaltgetriebe - Manual transmission
Automatikgetriebe - Automatic transmission
Radbolzen - Wheel stud
Zündschloss - Ignition switch
Nockenwelle - Camshaft
Kurbelwelle - Crankshaft
Kraftstoffpumpe - Fuel pump